
about=ебаут
all=ол
application=еплікейшн
applications=еплікейшнс
ation=ейшн
ations=ейшнс
back=бек
backspace=бекспейс
backup=бекап
caps=кепс
close=клоуз
e-mail=і-мейл
edge=едж
email=імейл
facebook=фейсбук
file=файл
files=файлс
feed=фід
gmail=джімейл
google=ґуґл
lock=лок
mail=мейл
message=меседж
меседж/1
messenger=мессенджер
мессенджер/1
mobile=мобайл
new=нью
news=ньюс
notification=нотіфікейшн
notifications=нотіфікейшнс
password=пессворд
пессворлд=1
play=плей
player=плеєр
read=рід
reader=рідер
see=сі
skype=скайп
space=спейс
tweet=твіт
ukraine=юкрейн
ukrainian=юкрейніан
viber=вайбер
вайбер/1